Level 1
#######
#oA   #
#@o @ #
# @   #
# o   #
#     #
#######