Level 8
#########
#   A   #
#   @   #
#o      #
#### ####
#     @o#
#@ ######
#o   @ o#
#########