Level 10
##########
#A @    o#
###### ###
#o   @   #
## #######
#   @  o #
###### ###
#o   @   #
## #######
#  @o$$$@#
##########