Level 11
################
#oA     o     o#
# @ @ @ @ @ @  #
#  @ @ @ @ @ @ #
# @ @oooooo @  #
#  @ oooooo@ @ #
#o@ @oooooo @ o#
#  @ oooooo@ @ #
# @ @oooooo @  #
#  @ @ @ @ @ @ #
#   @ @ @ @ @  #
#o      o     o#
################