Level 5
####################
#         A        #
# ###### ##### #####
#o@o        @      #
################## #
#                  #
# ##################
#      @          o#
##### ############ #
#                  #
# ############ #####
#          @    o@o#
####################