Level 9
###########
#o@A@  o  #
#### ######
#    #     
# @  #     
# @@@# ####
#oooo###  #
#    @    #
# @     oo#
###########