Level 2
########
#   ## #
#A @   #
#  o   #
# @  @o#
# o    #
###    #
########