########
#  oA@o#
#  @   #
# #    #
# #    #
# # @# #
#o @ o #
########